W W W W W W W W W W W W W W W W W W W W
W N N N W I I I W H H H W C C C W C C W
W N S N W I F I W H K H W C M C W C C W
W N N N W I I I W H H H W C C C W C C W
W W N W W W N W W W W W W W N W W C C W
W N N N N N N N N N N N N N N N N N N W
W N N N N N N N W W W W W N N N N N N W
W N N N N N N N W N N N W N N N N N N W
W N N N N N N N W N N N W N N N N N N W
W N N N N N N N W G G G W N N N N N N W
W N N N N N N N W N V N W N N N N N N W
W W W W W W W W W W W W W W W W W W W W 