W W W W W W W W W W W W W W W W W W W W W W W W W W W W W W W W W W W W W W W W 
W W N N N N N N N N N N N N N N N N N N N N N N N N N N N N N W N N N N N N N W
W W N W W W W W W W W W W W W W W W W W W W W W W W W W W W N W N N N N N N N W
W W N W W W W W W N N N N N N N N N N N N N N N N N N N N W N W N N N N N N N W
W W N N N N N N W N N N N N N N N N N N N N N N N N N N N W N W N N N N N N N W
W W W W W W W N W N N N N N N N N N N N N N N N N N N N N W N W N N N N N N N W
W N N N N N W N W W W W W W W W W W W N N N N N N N N N N W N W N N N N N N W W
W N N N N N W N N N N N N N N N N N W N N N N N N N N N N W N W N N N N N N N W
W N N N N N W W W W W W W W W W W N N N N N N N N N N N W W N W W N N N N N N W
W N N N N N N N N N N N N N N N W N W N N N N N N N N N W G G G W N N N N N N W
W N N N N N N N N N N N N N N N W N W N N N N N N N N N W V V V W N N N N N N W
W N N N N N N N N N N N N N N N W N W W W W W W W W W N W W W W W N N N N N N W
W N N N N N N N N N N N N N N N W N N N N N N N N N W N N N N N N N N N N N N W
W N N N N N N N N N N N N N N N W W W W W W W W W N W N N N N N N N N N N N N W
W N N N N N N N N N N N N N N N N N N N N N N N W N W N N N N N N N N N N N N W
W W W W W W W W W W W W W W W W W W W W W W W W W N W N N N N N N N N N N N N W
W W N N N N N N N N N N N N N N N N N N N N N N N N W N N N N N N N N N N N N W
W W W W W W W W W W W W W W W W W W W W W W W W W W W W W W W W W W W W W W W W